000000000000000000000000000000000000000000000000000000000000000000000000000000000000000000000000000000000000000000000
000000000000000000000000000000000000000000000000000000000000000000000000000000000000000000000000000000000000000000000
000000000000000000000000000000000000000000000000000000000000000000000000000000000000000000000000000000000000000000000
000000000000000000000000000000000000000000000000000000000000000000000000000000000000000000000000000000000000000000000
000000000000000000000000000000000000000000000000000000000000000000000000000000000000000000000000000000000000000000000
000000000000000000000000000000000000000000000000000000000000000000000000000000000000000000000000000000000000000000000
000000000000000000000000000000000000000000000000000000000000000000000040000000000000000000000000000000000000000000000
000000000000000000000000000000000000000000000000000000000000000000000167222221600000000000000000000000000000000000000
000000000000000000000000000000000000000000000000000000000000000000000055999555000000000000000000000000000000000000000
000000000000000000000000000000000000000000000000000000000000000000000005955500000000000000000000000000000000000000000
000000000000000000000000000000000000000000000000000000000000000167000000900000000000000000000000000000000000000000000
000000000000000000000000000000000000000000000000000000000000000000000000900000000000000000000000000000000000000000000
000000000000000000000000000000000000000000000000000000000000000000000000900000000000000000000000000000000000000000000
000000000000000000000000000000000000000000000000000000016700000000000000900000000000000000000000000000000000000000000
000000000000000000000000000000000000000000000000000000000000000000000000900000000000000000000000000000000000000000000
000000000000000000000000000000000000000000000000000000000000000000000000900000000000000000000000000000000000000000000
000000000000000000000000000000000000000000000000000000000000000167000000900000000000000000000000000000000000000000000
000000000000000000000000016700000001670000006700000000000000000000000000900000000000000000000000000000000000000000000
000000000000000000000000000000000000000000000000000000000000000000000162916700000000000000000000000000000000000000000
016700000167167167167222222222222222222222222222221671672222216700000055555000000000000000000000000000000000000000000
000000000555555555555555555555555555555555555555555555555555555500000000000000000000000000000000000000000000000000000