0000000000000000000000000000000000000000000000000000000000000000
0000000000000000000000000000000000000000000000000000000000000000
0000000000000000000000000000000000000000000000000000000000000000
0000000000000000000000000000000000000000000000000000000000000000
0000000000000000000000000000000000000000000000000000000000000000
0000000000000000000000000000000000000000001670000000000000000000
0000000000000000000000000000000000000000000000000000000000000000
0000000000000000000000000000000000000167000000000167000000000000
0000000000000000000000000000000000000000000000000000000000000000
1671671671000167167222222221671633167000000000000000000167000000
5555555555000555555999999995555588555167000000000000000000000040
5555555555000555555999999995555588888888333333333333333333333555
5555555555000555555999999995555588888855555588888555555555555555
5555555555000555555555555555555555555555555555555555555555555555