0000000000000000000000000000000000000000000000000000000000000000000000000000000000000000000000000000000000000000000000000000000000000
0000000000000000000000000000000000000000000000000000000000000000000000000000000000000000000000000000000000000000000000000000000000000
0000000000000000000000000000000000000000000000000000000000000000000000000000000000000000000000000000000000000000000000000000000000000
0000000000000000000000000000000000000000000000000000000000000000000000000000000000000000000000000000000000000000000000000000000000000
0000000000000000000000000000000000000000000000000000000000000000000000000000000000000000000000000000000000000000000000000000000000000
0000000000000000000000000000000000000000000000000000000000000000000000000000000000000000000000000000000000000000000000000000000000000
0000000000000000000000000000000000000000000000000000000000000000000000000000009000000000000000000000000000000000000000000000000000000
0000000000000000000000000000000000000000000000000000000000000000000000000000000000000000000000040000900000000000000000000000000000000
0000000000000000000000000000000000000000000000000000000000000000900000000000000000000000009000050000000000000000000000000000000000000
0000000000000000000000000000000000000000000000000000000000000000000000000000000000000500000000002222200000009000000000000000000000000
0000000000000000000000000000000000000000000000000000000000000000000000000000000590000090000000229559550000000000000000000000000000000
0000000000000000000000000000000000000000000000000000000000000000000000000005900000000000022222955599555000000000000000000000000000000
0000000000000000000000000000000000000000000000000000000000000000000000670000000000500022299555555995555555000000000000000000000000000
0167000000016700000001670000000016700000000071670000000001670000162221550900000000002295555555559999555555550000000000000000000000000
0000000000000000000000000000000000000000000000000000000000000000555555550000000000229555555555555555555555555000000000000000000000000